XXXXXXXXXXXX
XOOOXXXXOOOX
XOXOXOOOOXOX
XOOOOOXXOXOX
XOXXOXXXOOOX
XOOOOOOOOXXX
XXXXXXXXXXXX