XXXXXXXXXXXXXXXXXXXXXXXX
XOOXXXOOOOXXOOOOXXXXOOOX
XXOXXXOXXOOOOXXOXOOOOXOX
XXOXXXOXOOXXOXXOOOXXOXOX
XXOOOOOOOXOXOOXXOXXXOOOX
XXXXOXXXOOOXXOOOOOOOOXXX
XXOOOXXXXOXXXOXOXOXXXOXX
XOOOXXOOOOXXXOXOXOOOOOOX
XOXOXXOXXOOOXOXOXOXXXOXX
XOXOOOOXXXXOXOOOXXXOOOXX
XOXXOXOXOXOOOOXOOOOOXXXX
XOOOOXOXOOOXOXXOXOXOXOOX
XXOXOXOXXOXXXXOOOOXOOOXX
XXOXOOOXOOOOOXXOXOXXOXXX
XOOXOXXXOXXXOXXOXXOOOOOX
XOXOOOOOOOOXOXXOXOOXXXXX
XOOOXXXXOXOOOOXOXXOOOOOX
XOXOOOOXOXOXXOOOXXOXOXXX
XOOOXXOOOOOOOOXOOOOXOOOX
XXXXXXXXXXXXXXXXXXXXXXXX